name1	name2
AQUA	CADE
BEACH	HEAD
BLUE	ANCHOR
BLUE	ZEPHYR
BOUNDLESS	INFORMANT
BULL	RUN
BYE	MAN
COBALT	FALCON
CONTRA	OCTAVE
DEW	SWEEPER
DROP	MIRE
DRT	BOX
EGOTISTICAL	GIRAFFE
EGOTISTICAL	GOAT
ERRONEOUS	INGENUITY
EVENING	EASEL
EVIL	OLIVE
FAIR	VIEW
FOX	ACID
HIGH	LANDS
JUMP	SEAT
MADCAP	OCELOT
MONKEY	ROCKET
MOONLIGHT	PATH
OAK	STAR
ORANGE	BLOSSOM
ORANGE	CRUSH
PATH	FINDER
PIN	WALE
SHELL	TRUMPET
SHIFTING	SHADOW
SILK	WORTH
STELLAR	WIND
STORM	BREW
SILVER	ZEPHYR
THIN	TREAD
TRAFFIC	THIEF
TRAIL	BLAZER
XKEY	SCORE
YACHT	SHOP
AGILE	VIEW
AIR	GAP
AIR	STEED
AQUA	DOR
AUTO	SOURCE
BELL	TOPPER
BELL	VIEW
BLACK	FOOT
BLACK	HEART
BLACK	MAGIC
BLACK	PEARL
BLACK	WATCH
BULLS	EYE
CENTER	MASS
CHALK	FUN
CHASE	FALCON
CHEW	STICK
CIMBRI	CINEPLEX
COAST	LINE
COURIER	SKILL
CRISS	CROSS
DANCING	OASIS
DANGER	MOUSE
DARK	THUNDER
DECK	PIN
DISH	FIRE
DRAGON	FLY
FACE	LIFT
FALL	OUT
FISH	BOWL
FOX	TRAIL
GLOBAL	BROKER
HIDE	TIDE
HOME	BASE
INTEL	INK
IVY	BELLS
LIFE	SAVER
LONG	HAUL
MAGIC	LANTERN
MAIL	ORDER
MAIN	CORE
OIL	STOCK
OCT	SKYWARD
ONE	ROOF
PUZZLE	CUBE
SHARK	FIN
SKY	WRITER
SPOT	BEAM
STEEL	KNIGHT
STUMP	CURSOR
TALENT	KEYHOLE
TAPER	LAY
TAROT	CARD
TREASURE	MAP
TUNING	FORK
TUSK	ATTIRE
WEALTHY	CLUSTER
WEB	CANDID
WHITE	BOX
MONKEY	PUZZLE
DEITY	BOUNCE
ARK	STREAM
IRON	CHEF
WAGON	BED
FEED	TROUGH
ZESTY	LEAK
BANANA	GLEE
GOURMET	TROUGH
HALLUX	WATER
TURBO	PANDA
JET	PLOW
SOUFFLE	TROUGH
HEAD	WATER
HAMMER	MILL
SCHOOL	MONTANA
SIERRA	MONTANA
STUCCO	MONTANA
LOUD	AUTO
ANGRY	NEIGHBOR
NIGHT	STAND
NIGHT	WATCH
VIEW	PLATE
PHOTO	ANGLO
BLIND	DATE
TAWDRY	YARD
RAGE	MASTER
HOWLER	MONKEY
STRIKE	ZONE
IRATE	MONK
UNITE	DRAKE
STRAIT	BAZZARE
SLICKER	VICAR
JUNIOR	MINT
SOMBER	KNAVE
TWISTED	KILT
WISTFUL	TOLL
SURLY	SPAWN
DROPOUT	JEEP
CHIMNEY	POOL
FREE	FLOW
GOPHER	SET
MONKEY	CALENDAR
TOTE	CHASER
TOTE	GHOSTLY
CANDY	GRAM
CROSS	BEAM
ROCKY	KNOB
LAND	SHARK
HOLLOW	POINT
WATER	WITCH
COTTON	MOUTH
FIRE	WALK
DANDER	SPRITZ
